



-1 -1 -1 -1 -1 -1 -1 -1 -1 -1 -1 -1 1
-1 -1 -1 -1 -1 -1 -1 -1 -1 -1 -1 1 6 1
-1 -1 -1 -1 -1 -1 -1 -1 -1 -1 6 0 0 0 6  
-1 -1 -1 -1 -1 -1 -1 -1 -1 2 0 0 0 0 0 2
-1 -1 -1 -1 -1 -1 -1 -1 4 0 0 0 0 0 0 0 4
-1 -1 -1 -1 -1 -1 -1 5 0 0 0 0 0 0 0 0 0 5
-1 -1 -1 -1 -1 -1 3 0 0 0 0 0 0 0 0 0 0 0 3







